7 7
0 6
6 0
 6  1  2  6  7  5  3 
12  5 15 11 12  1 10 
 4  5  9 10  2  6  9 
 6  5  7  9 14 15  1 
10  4 15  5  9 12  3 
14  1 10  4  7  7  9 
12  5 13  5  9 12  1 
