7 7
0 0
6 4
 4  5  5  5  5  7  1  
 4  7  5  5  5  9  2  
 2 12  5  5  5  7  9 
14  7  7  5  7 13  1  
10  8 10  2 12  5  1  
 8  2 10 14  5  7  3 
 4 13 13  9  4  9  8
 